あいばー	サイバー	名詞	
あぽーと	サポート	名詞	
あれている	されている	動詞ラ行五段	
あれる	される	動詞ラ行五段	
あんぷる	サンプル	名詞	
うぎの	次の	名詞	
うぎのとおり	次のとおり	名詞	
うくりぷと	スクリプト	名詞	
うるもの	するもの	名詞	
えいじゃくせい	脆弱性	名詞	
えきない	できない	動詞ナ行五段	
えきゅりてぃ	セキュリティ	名詞	
えきようする	適用する	動詞サ変	
えきる	できる	動詞カ変	
えばいす	デバイス	名詞	
えふぉると	デフォルト	名詞	
がる	がある	名詞	
きけんせいがる	危険性がある	名詞	
しゅうせいあれた	修正された	名詞	
するほうほう	うる方法	名詞	
せっちあっぷ	セットアップ	名詞	
っぷでーと	アップデート	名詞	
ひつようがる	必要がある	名詞	
ひて	して	接続詞	
みにおぼえのない	身に覚えのない	形容詞	
れており	されており	動詞ラ行五段	
せつぞくがる	接続がある	名詞	
じっしうる	実施する	名詞	
しゅうりょううる	終了する	名詞	
いみがる	意味がある	名詞	
ふせいくせす	不正アクセス	名詞	
